11111111111111111111
10000000000000000001
10000000000000000001
10000300000000004401
10000300000000000401
10000300111220060401
10000300000220000401
10003300000020060401
100033000x0020060401
100033000x0020060401
100033020x0020060401
100033000x0020060401
10003302000020060401
10003302000020060001
10000002000020060001
100000020000206x0001
10000000000000000001
10000000000000000001
10000000000055555001
11111111111111111111
